0 0 0 0 0 0 0 0 0 0 0 0 0 0 2 2
0 0 P2 0 0 0 0 0 0 0 0 0 0 P3 0 2
0 0 0 0 0 0 0 0 2 2 2 0 0 0 0 0
0 0 0 0 2 2 2 2 3 4 2 2 0 0 0 0
0 0 0 0 0 0 0 0 5 6 2 2 0 0 0 0
0 0 0 0 0 0 0 0 0 0 2 2 0 0 0 0
0 0 0 3 4 0 0 0 0 0 0 2 0 0 0 0
0 0 0 5 6 0 0 0 0 0 0 2 0 0 0 0
0 0 0 2 2 0 0 N 0 0 0 2 0 0 0 0
0 0 0 0 2 0 0 0 0 0 0 2 0 0 0 0
0 0 0 0 2 0 2 2 0 0 0 2 0 0 0 0
0 0 0 0 2 2 2 2 2 2 2 2 0 0 0 0
0 0 0 0 0 0 0 0 0 0 0 0 0 0 0 0
0 0 0 0 0 0 0 0 0 0 0 0 0 0 0 0
0 0 0 0 0 0 0 0 0 0 3 4 0 0 0 0
0 0 0 0 3 4 0 0 0 0 5 6 0 0 0 0
0 0 0 0 5 6 0 0 0 0 2 2 0 0 0 0
0 0 0 0 0 0 0 0 0 0 0 0 0 0 0 0
0 0 P1 0 0 0 E 0 0 0 0 0 0 P4 0 0
0 0 0 0 0 0 0 0 0 0 0 0 0 0 0 0
2 2 0 0 0 0 0 0 0 0 0 0 0 0 0 0
2 2 0 0 0 0 0 0 0 0 0 0 0 0 0 0
Name: Getting Started